##################################################################
###############------------------------------------###############
#############----------------------------------------#############
###########--------------------------------------------###########
#########----------------------------------------------###########
#########----------------------------------------------##--#######
#####--------------------------------------------------##----#####
#####--------------------------------------------------##----#####
#####--------------------------------------------------DD----#####
#####--------------------------------------------------##S---#####
#####--------------------------------------------------##----#####
#########----------------------------------------------##--#######
#########----------------------------------------------###########
###########--------------------------------------------###########
#############----------------------------------------#############
###############------------------------------------###############
##################################################################
