111111110000000000000000000000000000000000000000000000000000000000
111111110000000000000000000000000000000000000000000000000000000000
111111110000000000000000000000000000000000000000000000000000000000
111111110000000000000000000000000000000000000000000000000000000000
111111110000000000000000000000000000000000000000000000000000000000
111111110000000000000000000000000000000000000000000000000000000000
111111110000000000000000000000000000000000000000000000000000000000
111111110000000000000000000000000000000000000000000000000003333333
111111110000000000000000000000000000000000000000000000000003333333
111111110000000000000000000000000000000000000000000000000003333333
111111110000000000000000000000000000000000000000000000000003333333
111111110000000000000000000000000000000002222222222220000000000000
111111110000000000000000000000000000000002222222222220000000000000
111111110000000000000000000000000000000002222222222220000000000000
111111110000000000000000000000000000000002222222222220000000000000
111111110000000000000000000000000000000002222222222220000000000000
111111110000000000000000000000000000000002222222222220000000000000
