##################################################################
###################----------------G--##-S-##------###############
#################---------------------##---##--------#############
###########------GG---------------GG--###D###--------CC###########
#########---------G-------------TTTBT-###D###---------CCC#########
#########-------------GG--------TTBTP----------------------#######
#####--##-------------G--------------------GG----------TTT---#####
#####--##-----------------TT---------------------------TTT---#####
#####--DD-----------------TP----------------G----------TTT---#####
#####S-##-----------------TB---------------------------TTT---#####
#####--##-----------------TC---------------GG----------TTT---#####
#########-----------------TT-------------------------------#######
#########----------------------TTTBTTT----------------CCC#########
###########--------------------TTTTTPT------####D#################
#############---GG--------------------------####D#################
###############-GGGG------------------------##-----###############
##################################################################
