##################################################################
###################--------------------------------###############
#################--------------CC------------------TT#############
###########------------CCC-----CC-----------------CTT--###########
#########-------CC-----CCC-------------------------TT----#########
#########-------CC-----CCC-------------------------TT-----########
#####--##-------------------------------------------------########
#####S-##------------------CC-----------------------------##-#####
#####--DD-----CCC----------CC-----------------------------DDA#####
#####-S##-----CCC-----------------------------------------##-#####
#####--##-------------------------------#####D########----##-#####
#########-------------------------------#####D########----########
#########-------------------------------##----------##---#########
###########------------------SSSSS------##----BB----##-###########
#############----------------SSSSS------##----BB----##############
###############--------------SSSSS------##---TBBT--###############
##################################################################
