##################################################################
###############------------------------------------###############
#############----------------Z----CC-----Z-----------#############
###########-----CC----------------CC-------------CC----###########
#########-------CC--------------------------Z----CC-----##########
#########------------CC----Z-------------------CC-------##########
#####--##------------CC-----------CC----Z------CC-------##---#####
#####--##-------------------------CC--------------------##---#####
#####--DD-----------------CC----------------------------DD---#####
#####-S##---------CC------CC----Z-------Z---------------##--S#####
#####--##---------CC--------------CC--------------------##---#####
#########-------------------Z-----CC--------------------##########
#########-------------------------------------CC--------##########
###########--------------CC-------------------CC-------###########
#############------------CC---Z---------Z------------#############
###############------------------------------------###############
##################################################################
