##################################################################
###############------------------------------------###############
#############----------------------------------------#############
###########--------------------------------------------###########
#########----------BB------------------------------------#########
#########----------BB--------------------------------------#######
#####--------------------------------------------------------#####
#####------BB------CGC---BB---------------------------------S#####
#####------BB------------BB-----M----------------------------#####
#####--------------------------------------------------------#####
#####--------------BB----------------------------------------#####
#########----------BB--------------------------------------#######
#########------------------------------------------------#########
###########--------------------------------------------###########
#############----------------------------------------#############
###############------------------------------------###############
##################################################################
