##################################################################
###################-BB-TTT---------------BB----C---###############
#################---BB--C----------------BB--TTTTT---B############
###########BBBBBBBB-BBBBBBBBBBB-BBBBBBBBBBB----------B############
#########T--B----------------------------------------B############
#########T-----BBBBB-BBBBBBBBBB-BBBBBBBBBBBBBBBBBBBBBBBB##########
#####--##B--B--B-----BB-------B-B---------B---B---------##########
#####--##BBBB--BBBBBBBB---BBBBB-----------B---B---------##---#####
#####--DD----------BBBB-BBB---------------B---B---------DD-S-#####
#####S-##BBBBBBBB--BB-------------Z---------Z-----------##---#####
#####--##----------BBBBBBBB-----------------------------##---#####
#########----------BB-------------Z-------Z-------------##########
#########BBBBBBB-BBBBBBBBBB-----------------------------##########
###########BB------BB-------------Z-----G--------------###########
#############B-----BBBBBBBB-----------TTTTT---------##############
###############BBBBBB-----------------TTTTT--------###############
##################################################################
