##################################################################
##################################################################
##################################################################
##################################################################
##################################################################
#########--Z--Z--Z--Z--Z--Z--Z--Z--Z--Z--Z--Z--Z--Z--Z--##########
#####--##-----------------------------------------------##########
#####S-##-----------------------------------------------##---#####
#####--DD-----------------------------------------------DD---#####
#####--##-----------------------------------------------##--S#####
#####--##-----------------------------------------------##---#####
#########-----------------------------------------------##########
#########--Z--Z--Z--Z--Z--Z--Z--Z--Z--Z--Z--Z--Z--Z--Z--##########
##################################################################
##################################################################
##################################################################
##################################################################
