##################################################################
###############BBBBBBBBBBBBBBBBBBBBBBBBBBBBBBBBBBBB###############
#############BB----BB-------------------------BB---BB#############
###########BB------BB---BB-----TTTTTT---BB----BB-----BB###########
#########----------BB---BB-----TTTTTT---BB----BB-------BB#########
#########----------BB---BB-----TTTTTT---BB----BB-----------#######
#####--##----------BB---BB--------------BB-------------------#####
#####S-##---------------BB-----------------------------------#####
#####--DD------------------------------L---------------------#####
#####--##------------------------------L---------------------#####
#####--##----------------------------------------------------#####
#########-------BBBBBBB------------------BB----------------#######
#########-------BBBBBBB------------------BB--------------#########
###########BB---BB-----------------------BB------------###########
#############BB-BB-----------------------BB----------#############
###############BBBB----------------------BB--------###############
##################################################################
