##################################################################
###############CCCCCCCCCCFFCCCCCCCCSSSSCCCCCCCCCCC################
#############CCCCCCCCCCCCFFCCCCCCCCSSSSCCCCCCCCCCCCC##############
###########CCCCC--------------------------------------############
#########CCCCCCC---------------------------------------###########
#########CCCCCCC---------------------------------------###########
#####--##-----------------PPPPPPPPP---------------------##---#####
#####S-##-----------------PPPPPPPPP---------------------##---#####
#####--DD-----------------PPPPPPPPP---------------------DD---#####
#####--##-----------------PPPPPPPPP---------------------##S--#####
#####--##-----------------------------------------------##---#####
#########-----------C--C-------------------------------###########
#########----------TTTTTT------------------------------###########
###########-------CTTTTTTC-----------------------------###########
#############------TTTTTT------------CCCCCCCCCCCCCCCC#############
###############-----C--C-------------CCCCCCCCCCCCCC###############
##################################################################
