111111110000000000000000000000000000000333330000000000000000000000
111111110000000000000000000000000000000333330000000000000000000000
111111110000000000000000000000000000000333330000000000000000000000
111111110000000000000000000000000000000333330000000000000000000000
111111110000000000000000000000000000000000000000000000000000000000
111111110000000000000000000000000000000000000000000000000000000000
111111110000000000000000000000000000000000000000000000000000000000
111111110000000000000000000000000000000000000000000000000000000000
111111110000000000000000000000000000000000000000000000000000000000
111111110000000000000000000000000000000000000000000000000000000000
111111110000000000000000000000000000000000000000000000000000000000
111111110000000000000000000000000000000000000000000000000000000000
111111110000000000000000000000000000000000000000000000000000000000
111111110000000000000000000000000000000000000000000000000000000000
111111110000000000000000000000000000000000000222222200000000000000
111111110000000000000000000000000000000000000222222200000000000000
111111110000000000000000000000000000000000000222222200000000000000
