##################################################################
###################--------------------------------###############
#################------------------------------------#############
###########--------------------------------------------###########
#########------------------------------------------------#########
#########--------------------------------------------------#######
#####--##---------------------------------------------------######
#####S-##----------------------------------------------------#####
#####--DD----------------------------------------------------#####
#####--##----------------------------------------------------#####
#####--##----------------------------------------------------#####
#########--------------------------------------------------#######
#########------------------------------------------------#########
###########--------------------------------------------###########
#############----------------------------------------#############
###############------------------------------------###############
##################################################################
