000000008888888888888999999999999999999996666666666666666666666666
000000008888888888888999999999999999999996666666666666666666666666
000000008888888888888999999999999999999996666666666666666666666666
000000005555444466666666666666666666666666666666666666666666666666
000000005555444466666666666666666666666666666666666666666666666666
000000005555444466666666666666666666666666666666666666666666666666
0000000055554444777777AAAAAAAACCCCCCCCCCCCCCCCCCCCCCCCCCCBBBBBBBBB
0000000011111111111177AAAACCCCCCCCCCCCCCCCCCCCCCCCCCCCCCCBBBBBBBBB
00000000111111111111CCCCCCCCCCCCCCCCCCCCCCCCCCCCCCCCCCCCCBBBBBBBBB
00000000111111111111CCCCCCCCCCCCCCCCCCCCCCCCCCCCCCCCCCCCCBBBBBBBBB
00000000222222222222CCCCCCCCCCCCCCCCCCCCCCCCCCCCCCCCCCCCCBBBBBBBBB
00000000222222222222CCCCCCCCCCCCCCCCCCCCCCCCCCCCCCCCCCCCCBBBBBBBBB
00000000222222222222CCCCCCCCCCCCCCCCCCCCCCCCCCCCCCCCCCCCCCCCCCCCCC
00000000333333333333CCCCCCCCCCCCCCCCCCCCCCCCCCCCCCCCCCCCCCCCCCCCCC
00000000333333333333CCCCCCCCCCCCCCCCCCCCCCCCCCCCCCCCCCCCCCCCCCCCCC
00000000333333333333CCCCCCCCCCCCCCCCCCCCCCCCCCCCCCCCCCCCCCCCCCCCCC
00000000333333333333CCCCCCCCCCCCCCCCCCCCCCCCCCCCCCCCCCCCCCCCCCCCCC
