##################################################################
###################----CC--------CC------CC--------###############
#################-------------------------------------############
###########------------------------------RRRR---------############
#########--------------BB----------------RRRR---------############
#########------------------B----------------------------##########
#####--##---------BB------------------------------------##########
#####--##--------------BB-------------------------------##---#####
#####--DD---------BB------------------------------------DD--S#####
#####S-##-------------B---------------------------------##---#####
#####--##------------B----BB----------------------------##---#####
#########-----BB----------------------------------------##########
#########-----------BB----------------------------------##########
###########--------------------------------------------###########
#############---------------------------------------##############
###############-----CC------CGC----------CC--------###############
##################################################################
