111111112222222222222222222222266633333333333333333333333333333333
111111112222222222222222222222266633333333333333333333333333333333
111111112222222222222222222222266633333333333333333333333333333333
111111112222222222222222222222266633333333333333333333333333333333
111111112222222222222222222222266633333333333333333333333333333333
111111112222222222222222222222266633333333333333333333333333333333
111111112222222222222222222222266633333333333333333333333333333333
111111110000000000000000000000000000000000000000000000000000000000
111111110000000000000000000000000000000000000000000000000000000000
111111110000000000000000000000000000000000000000000000000000000000
111111115555555555555555555555577744444444444444444444444444444444
111111115555555555555555555555577744444444444444444444444444444444
111111115555555555555555555555577744444444444444444444444444444444
111111115555555555555555555555577744444444444444444444444444444444
111111115555555555555555555555577744444444444444444444444444444444
111111115555555555555555555555577744444444444444444444444444444444
111111115555555555555555555555577744444444444444444444444444444444
