##################################################################
###################-------------------##--S##------###############
#################------TTTTT----------##---##--------#############
###########------------TTBTT----------###D###----------###########
#########-----------------------------###D###------------#########
#########------------------------------------------TT------#######
#####--##------PPPPPPPPP--------PPPPP--------------TI-------######
#####--##------------------------------------------TT--------#####
#####--DD------PPPPPPPPP--------PPPPPPPPP----------TI--------#####
#####S-##------------------------------------------TT--------#####
#####--##------PPPPPPPPP------- PPPPPPPPP----------TI--------#####
#########------------------------------------------TT------#######
#########------PPPPPPPPP--------PPPPPPPPP----------------#########
###########----------------PP--------------------------###########
#############--------------PB------------------------#############
###############TTTTTTTTTTTTTTTTTTTTTTTTTTTTTTTTTTTT###############
##################################################################
