##################################################################
###################-------------------##--S##------###############
#################------TTTTT----------##---##--------#############
###########------------TTTTT----------###D###----------###########
#########-----------------------------###D###------------#########
#########--------------------------------------------------#######
#####--##------PPPPPPPPP--------PPPPP-----------------------######
#####--##----------------------------------------------------#####
#####--DD------PPPPPPPPP--------PPPPPPPPP--------------------#####
#####S-##----------------------------------------------------#####
#####--##------PPPPPPPPP------- PPPPPPPPP--------------------#####
#########--------------------------------------------------#######
#########------PPPPPPPPP--------PPPPPPPPP----------------#########
###########----------------CC--------------------------###########
#############--------------CC------------------------#############
###############------------------------------------###############
##################################################################
