##################################################################
###############------------------------------------###############
#############----------------------------------------#############
###########--------------------------------------------###########
#########------------------------------------------------#########
#########--------------------------------------------------#######
#####--------------------------------------------------------#####
#####-------------------------------------------------------S#####
#####---------------------------M----------------------------#####
#####--------------------------------------------------------#####
#####--------------------------------------------------------#####
#########--------------------------------------------------#######
#########------------------------------------------------#########
###########--------------------------------------------###########
#############----------------------------------------#############
###############---------------CGC------------------###############
##################################################################
